#                                                                                                                               
#                                                                                                                               
#                                                                                                                               
#                                                         #######                                                               
#                                    ###                                                                                        
#                               #####     #######  ###########                                                                 #
#                                   EEE                                              #                                         #
#                      ######################                              #############  ########  ########                   #
#   #     #         ########                EEEE                       ########               E     ##########                 #
################################################################################################################################